NO ./textures/Test_N.xpm
SO ./textures/Test_S.xpm
WE ./textures/Test_W.xpm
EA ./textures/Test_E.xpm

F 82,67,54
C 0,0,0

        1111111111111111111111111
		1000000000110000000000001
        1011000001110000000000001
        1001000000000000000000001
111111111011000001110000000000001
100000000011000001110111111111111
11110111111111011100000010001
11110111111111011101010010001
10000000000000000000000000001
11000000110101011100000010001
10000000000000001100000010001
10000000000000001101W10010001
110000011101010111110111100111
11110111 1110101 101111010001
11111111111111111111111111111
