NO ./inc/textures/Red_DarkWall_01.xpm
SO ./inc/textures/Red_LightWall_01.xpm
WE ./inc/textures/Red_DarkWall_02.xpm
EA ./inc/textures/Red_LightWall_02.xpm

F 82,67,54
C 0,0,0

111111111111111111111111111111111111111111111111111111111111
100000000000000000000000000000000000000000000000000000000001
101111111111111111111000111111111111111111111111111111111101
100000000000000000001000100000000000000000000000000000000001
111111111111111110001111101111111111111111111111111111110001
100000000000000010001000001000000000000000000000000000010001
101111111111111010001000111000111111111111111111111110010001
100000000000001010001000100000100000000000000000000010010001
111111111111101010111110101111101111111111111111111010010001
1000000000001010100000001000000010000000S0000000001010010001
101111111110101011111111111111101111111111111111101010010001
100000000010101000000000000000001000000000000000001010010001
111111110010101111111111111111101011111111111111101010010001
100000010010100000000000000000001010000000000000001010010001
101111010010111111111111111110001010111111111111101010010001
100001010010000000000000000010001010100000000000001010010001
111101010011111111111111111010111010101111111111101010010001
100001010000000000000000001010001010001000000000001010000001
101111011111111111111111101010111011111011111111101011111101
100000000000000000000000001010000000000010000000001000000001
111111111111111111111111111010111111111110111111111111111111
100000000000000000000000001010000000000000000000000000000001
101111111111111111111111101010111111111111111111111111111101
100000000000000000000000001000100000000000000000000000000001
111111111111111111111111111111111111111111111111111111111111