NO textures/game/wall_north.xpm
SO textures/game/wall_south.xpm
WE textures/game/wall_west.xpm
EA textures/game/wall_east.xpm

F 236, 211, 159
C 85, 90, 130

11111
10001
10S01
10001
10001
10011
11111
10001
10001
10001
10001
10101
11111