NO ./inc/textures/Red_DarkWall_01.xpm
SO ./inc/textures/Red_LightWall_01.xpm
WE ./inc/textures/Red_DarkWall_02.xpm
EA ./inc/textures/Red_LightWall_02.xpm

F 220,100,0
C 225,90,0

1111111111111111111       11111111
1000000000000000000111111110000001
1000000000000000000000000111100001
1000000000000000010000000000000001
100000000000000011100000000000001
100000000000000001000000000000001
100000000000000000000000001000001
100000000000000000000000000000001
100000000000001111110000000000001
111111111111111    10000000000001   1111111
100000000000001111110000000000001  1000001
10000000000000000000000000000000011000001
100000000000000000000000000000000000000N1
10000000000000000000000000000000011111111
10000000000011111100000000000000001
1111111111111    111111111111111111
