NO ./inc/textures/wall.xpm
SO ./inc/textures/wall.xpm
WE ./inc/textures/wall.xpm
EA ./inc/textures/wall.xpm

F 220,100,0
C 225,90,0

111111111111111111111111111111111111
100000000000000000000000000000000001
100000000000000000000000000000000001
100000000000000000000000000000000001
100000000000000001000000000000000001
100000000000000000000000000000000001
10000000000000000N000000001000000001
100000000000000000000000000000000001
100000000000000000000000000000000001
100000000000000000000000000000000001
100000000000000000000000000000000001
111111111111111111111111111111111111
