NO ./inc/textures/wall.xpm
SO ./inc/textures/wall.xpm
WE ./inc/textures/wall.xpm
EA ./inc/textures/wall.xpm

F 220,100,0
C 225,90,0

1111111111111111111111111111111111
1000000000000000000000000000000001
1000000000000000000000000111100001
1000000000000000010000000000000001
1000000000000000111000000000000001
1000000000000000010000000000000001
1000000000000000000000000010000001
1000000000000000000000000000000001
1000000000000000000000000000000001
1111111111111110000000000000000001
1000000000000000000000000000000001
1000000000000000000000000000000001
1000000000000000000000000000000001
1000000000000000000000000000000001
10000000000000000N0000000000000001
1111111111111111111111111111111111
