NO ./inc/textures/StoneWall_North.xpm
SO ./inc/textures/StoneWall_South.xpm
WE ./inc/textures/StoneWall_West.xpm
EA ./inc/textures/StoneWall_East.xpm

F 220,100,0
C 225,90,0

        1111111111111111111111111
		1000000000110000000000001
        1011000001110000000000001
        1001000000000000000000001
111111111011000001110000000000001
100000000011000001110111111111111
11110111111111011100000010001
11110111111111011101010010001
11000000110101011100000010001
10000000000000001100000010001
10000000000000001101N10010001
110000011101010111110111100111
11110111 1110101 101111010001
11111111111111111111111111111
