NO ./inc/textures/StoneWall_North.xpm
SO ./inc/textures/StoneWall_South.xpm
WE ./inc/textures/StoneWall_West.xpm
EA ./inc/textures/StoneWall_East.xpm

F 220,100,0
C 225,90,0

   11111
1110000N1
110001011
110000001
11111001
    111
