NO ./inc/textures/wall_oldred.xpm
SO ./inc/textures/wall_oldred.xpm
WE ./inc/textures/wall_oldred_dark.xpm
EA ./inc/textures/wall_oldred_dark.xpm

F 220,100,0
C 225,90,0

1111111111111111111111111111111111
1000000000000000000000000000000001
1000000000000000000000000111100001
1000000000000000010000000000000001
100000000000000011100000000N000001
1000000000000000010000000000000001
1000000000000000000000000010000001
1000000000000000000000000000000001
1000000000000000000000000000000001
1111111111111110000000000000000001
1000000000000000000000000000000001
1000000000000000000000000000000001
1000000000000000000000000000000001
1000000000000000000000000000000001
1000000000000000000000000000000001
1111111111111111111111111111111111
