NO ./inc/textures/Red_DarkWall_01.xpm
SO ./inc/textures/Red_LightWall_01.xpm
WE ./inc/textures/Red_DarkWall_02.xpm
EA ./inc/textures/Red_LightWall_02.xpm

F 82,67,54
C 0,0,0

111111111111111111111111111111111111111111111111111111111111
100000000000000000000000000000000000000000000000000000000001
100000000000000000000000000000000000000000000000000000000001
100000000011111000000000000000000000000000000111110000000001
100000000010001000000000000000000000000000000100010000000001
100000000010001000000000000000000000000000000100010000000001
100000000011111000000000000000000000000000000111110000000001
100000000000000000000000000000000000000000000000000000000001
100000000000000000000000000000000000000000000000000000000001
100000000000000000000001111111111100000000000000000000000001
100000000000000000000001000000000100000000000000000000000001
100000000000000000000001000000000100000000000000000000000001
100000000000000000000001111111111100000000000000000000000001
100000000000000000000000000000000000000000000000000000000001
100000000000000000000000000111110000000000000000000000000001
10000000000000000000000000010N000000000000000000000000000001
100000000000000000000000000111110000000000000000000000000001
100000000000111111000000000000000000000011111100000000000001
100000000000100001000000000000000000000010000100000000000001
100000000000100001000000000000000000000010000100000000000001
100000000000111111000000000000000000000011111100000000000001
100000000000000000000000000000000000000000000000000000000001
100000000000000000000000000000000000000000000000000000000001
100000000000000000000000000000000000000000000000000000000001
100000000000000000000000000000000000000000000000000000000001
100000000000000000000000000000000000000000000000000000000001
100000000000000000000000000000000000000000000000000000000001
100000000000000000001111111000000000000000000000000000000001
100000000000000000001000001000000000000000000000000000000001
100000000000000000001000001000000000000000000000000000000001
100000000000000000001111111000000000000000000000000000000001
100000000000000000000000000000000000000000000000000000000001
100000000000000000000000000000000000000000000000000000000001
111111111111111111111111111111111111111111111111111111111111