NO ./textures/Red_DarkWall_01.xpm
SO ./textures/Red_LightWall_01.xpm
WE ./textures/Red_DarkWall_02.xpm
EA ./textures/Red_LightWall_02.xpm

F 20,20,20
C 200,200,200

1111111110
1001110011
111S111101
1000110001
1010110101
1111111111

1111111110
1001110011
1110111101
1000110001
1010110101
1111111111
