NO ./inc/textures/Red_DarkWall_01.xpm
SO ./inc/textures/Red_LightWall_01.xpm
WE ./inc/textures/Red_DarkWall_02.xpm
EA ./inc/textures/Red_LightWall_02.xpm

F 20,20,20
C 200,200,200

11111 11110
10011 10011
111S1 11100
10001 10001
10101 10101
11111 01111
